30 30
100 100
16 16 16 16 16 16 16 16 16 16 16 16 16 16 16 16 16 16 16 16 16 16 16 16 16 16 16 16 16 16
16 13 15 13 13 13 13 13 13 13 13 13 13 13 16 16 16 16 16 16 16 16 16 16 16 16 16 16 16 16
16 13 13 13 13 13 13 13 13 13 13 13 13 15 13 13 16 16 16 16 16 16 16 16 16 16 16 16 16 16
16 13 13 13 13 13 13 15 15 15 15 15 13 13 13 13 13 16 16 16 16 16 16 16 16 16 16 16 16 16
16 16 13 13 13 13 13 15 15 15 15 15 13 13 13 13 13 13 16 16 16 16 16 16 16 16 16 16 16 16
16 16 13 13 13 13 13 13 15 15 15 15 13 15 3  13 13 13 13 13 16 16 16 16 16 16 16 16 16 16
16 16 16 13 13 13 13 13 15 15 15 15 13 13 13 13 13 13 13 13 13 16 16 16 16 16 16 16 16 16
16 16 16 13 13 13 13 15 13 13 13 15 13 13 13 13 13 13 13 13 13 13 13 13 16 16 16 16 16 16
16 16 16 16 13 13 13 13 3  13 13 15 15 13 13 13 13 13 13 13 13 13 13 13 13 16 16 16 16 16
16 16 16 16 13 13 3  3  3  13 13 13 13 13 13 13 13 13 13 13 13 13 13 13 13 16 16 16 16 16
16 16 16 16 16 13 3  13 13 13 13 13 13 13 13 13 13 13 13 13 13 13 13 13 13 13 16 16 16 16
16 16 16 16 16 13 3  13 13 13 13 3  13 13 13 13 13 13 13 13 13 13 13 13 13 13 13 16 16 16
16 16 16 16 16 16 13 13 13 13 13 13 13 13 13 13 13 13 13 13 13 13 13 13 13 13 13 13 16 16
16 16 16 16 16 16 13 13 13 13 13 13 13 13 13 13 13 13 13 13 13 13 13 13 13 13 13 13 16 16
16 16 16 16 16 16 16 13 13 15 13 13 13 13 13 13 13 13 13 13 13 13 13 13 13 13 13 13 13 16
16 16 16 16 16 16 16 16 13 13 13 13 13 13 13 13 13 13 13 13 13 13 13 13 13 13 13 13 13 16
16 16 16 16 16 16 16 16 16 16 13 13 3  13 15 13 13 13 13 13 13 13 13 13 13 13 13 13 13 16
16 16 16 16 16 16 16 16 16 16 16 16 13 13 13 13 13 13 13 13 13 13 13 13 13 13 13 13 13 16
17 17 17 17 17 17 17 17 17 17 17 17 17 13 13 17 17 17 17 17 17 17 17 17 17 17 17 17 17 17
17 14 14 14 14 14 14 14 14 14 14 14 14 14 14 14 14 14 14 14 14 14 14 14 14 14 14 14 14 17
17 14 14 14 14 14 14 14 14 14 14 14 14 14 14 14 14 14 14 14 14 14 14 14 14 14 14 14 14 17
17 14 14 14 14 14 14 14 14 14 14 14 14 14 14 14 14 14 14 14 14 14 14 14 14 14 14 14 14 17
17 14 14 14 14 14 14 14 14 14 14 14 14 14 14 14 14 14 14 14 14 14 14 14 14 14 14 14 14 17
17 14 14 14 14 14 14 14 14 14 14 14 14 14 14 14 14 14 14 14 14 14 14 14 14 14 14 14 14 17
17 14 14 14 14 14 14 14 14 14 14 14 14 14 14 14 14 14 14 14 14 14 14 14 14 14 14 14 14 17
17 14 14 14 14 14 14 14 14 14 14 14 14 14 14 14 14 14 14 14 14 14 14 14 14 14 14 14 14 17
17 14 14 14 14 14 14 14 14 14 14 14 14 14 14 14 14 14 14 14 14 14 14 14 14 14 14 14 14 17
17 14 14 14 14 14 14 14 14 14 14 14 14 14 14 14 14 14 14 14 14 14 14 14 14 14 14 14 14 17
17 14 14 14 14 14 14 14 14 14 14 14 14 14 14 14 14 14 14 14 14 14 14 14 14 14 14 14 14 17
17 17 17 17 17 17 17 17 17 17 17 17 17 17 17 17 17 17 17 17 17 17 17 17 17 17 17 17 17 17