30 30
100 100
16 16 16 16 16 16 16 16 16 16 16 16 16 16 16 16 16 16 16 16 16 16 16 16 16 16 16 16 16 16
16 15 13 15 15 15 15 15 15 15 15 15 15 15 16 16 16 16 16 16 16 16 16 16 16 16 16 16 16 16
16 15 15 15 15 15 15 15 15 15 15 15 15 15 15 15 16 16 16 16 16 16 16 16 16 16 16 16 16 16
16 15 15 15 15 15 15 15 15 15 15 15 15 15 15 15 13 16 16 16 16 16 16 16 16 16 16 16 16 16
16 16 15 15 15 15 15 15 15 15 15 15 15 15 15 15 15 15 16 16 16 16 16 16 16 16 16 16 16 16
16 16 15 15 15 15 15 15 15 15 15 15 15 15 15 15 15 15 15 15 16 16 16 16 16 16 16 16 16 16
16 16 16 15 15 15 15 15 15 15 15 15 15 15 15 15 15 15 15 15 15 16 16 16 16 16 16 16 16 16
16 16 16 15 15 15 15 15 15 15 15 15 15 15 15 15 15 15 15 15 15 13 13 13 16 16 16 16 16 16
16 16 16 16 15 15 15 15 15 15 15 15 15 15 15 15 15 15 15 15 13 13 13 13 13 16 16 16 16 16
16 16 16 16 15 15 15 15 15 15 15 15 15 15 15 15 15 15 15 15 13 13 13 13 13 16 16 16 16 16
16 16 16 16 16 15 15 15 15 15 15 15 15 15 15 15 15 15 15 15 13 13 13 13 13 13 16 16 16 16
16 16 16 16 16 15 15 15 15 15 15 15 15 15 15 15 15 15 15 15 13 13 13 13 13 13 13 16 16 16
16 16 16 16 16 16 15 15 15 15 15 15 15 15 15 15 15 15 15 15 13 13 13 13 13 13 13 13 16 16
16 16 16 16 16 16 15 15 15 15 15 15 15 15 15 15 15 15 15 13 13 13 13 13 13 13 13 13 16 16
16 16 16 16 16 16 16 15 15 15 15 15 15 15 15 15 15 15 13 13 13 13 13 13 13 13 13 13 13 16
16 16 16 16 16 16 16 16 15 15 15 15 15 15 15 15 15 13 13 13 13 13 13 13 13 13 13 13 13 16
16 16 16 16 16 16 16 16 16 16 14 14 14 15 15 15 13 13 13 13 13 13 13 13 13 13 13 13 16 16
16 16 16 16 16 16 16 16 16 16 16 16 14 14 13 13 13 13 13 13 13 13 13 13 13 13 13 16 16 16
17 17 17 17 17 17 17 17 17 17 17 17 14 14 17 17 17 17 17 17 17 17 17 17 17 17 17 17 17 17
17 17 17 17 17 17 17 17 17 17 17 17 14 14 14 14 14 14 14 14 14 14 14 14 14 17 17 17 17 17
17 17 17 17 17 17 17 17 17 17 17 17 17 14 14 14 14 14 14 14 14 14 14 14 14 14 14 17 17 17
17 17 17 14 17 17 17 17 17 17 17 17 17 17 17 14 14 14 14 14 14 14 14 14 14 14 14 14 17 17
17 17 14 14 17 17 17 17 17 17 17 17 17 17 17 17 14 14 14 14 14 14 14 14 14 14 14 14 14 17
17 17 14 14 14 17 17 17 17 17 17 17 17 17 17 17 17 14 14 14 14 14 14 14 14 14 14 14 14 17
17 17 14 14 14 14 14 17 17 17 17 17 17 17 17 17 17 17 14 14 14 14 14 14 14 14 14 14 14 17
17 17 14 14 14 14 14 14 14 14 17 17 17 17 17 17 17 17 14 14 14 14 14 14 14 14 14 14 17 17
17 17 14 14 14 14 14 14 14 14 14 14 14 17 17 17 17 14 14 14 14 14 14 14 14 14 14 14 17 17
17 17 17 14 14 14 14 14 14 14 14 14 14 14 14 14 14 14 14 14 14 14 14 14 14 14 14 17 17 17
17 17 17 17 17 14 14 14 14 14 14 14 14 14 14 14 14 14 14 14 14 14 14 14 14 14 17 17 17 17
17 17 17 17 17 17 17 17 17 17 17 17 17 17 17 17 17 17 17 17 17 17 17 17 17 17 17 17 17 17